1111111111111111111
1000D10000000D00001
1C00010000000011101
111001001C111010101
100C00000000000E0P1
1111111111111111111
