1111111111111111111
1000D1000C000D00001
1C00010000000011101
111001001C111010101
100C00000000000E0P1
100111D111111110001
1000000010000000001
100C0000D0000C00001
1111111111111111111
