11111111111111111111111111111111111111
10000000000000000000000000000000000001
10111111111111111111111111111111111101
10100000000010101010101000000000000101
10100000000010101010101000000000000101
101000000000C010C010C01000000000000101
10100000000010101010101000000000000101
10100000000010101010101000000000000101
10100000000010101010101000000000000101
10100000000010101010101000000000000101
10100000000010101010101000000000000101
10100000000010101010101000000000000101
101000000000C0C0C0C0C0C000000000000101
10100000000010101010101000000000000101
101E000000001010101010100000000000P101
10111111111111111111111111111111111101
10000000000000000000000000000000000001
11111111111111111111111111111111111111
