111111111111111111111111111111111111111
1000000010C01100000000000000010001000E1
100000100010000000000000010100010000001
1C0000001000110010C01010110001000100001
100000100010011000100100010100010000001
100000001000110010001001010001000100001
100000100010011000100100010100010000001
111111101000110011011110110001000100001
100000001000000100000000100111111111101
1000000011111111101111101000000000000C1
100000001010000000101000011110000000001
1000P0001100111011100011000001001000001
100000001001010100001100110100100010001
1000000010100000011100000010C0001000001
100000000000101110000000000100100010001
111111111111111111111111111111111111111
