111111111111111111111111111111111111111
1C01000000001000100000000000001C00100E1
100000001000000010000001000000100010001
100010001001010010011001001000100000001
101010001001010010100101001000101000101
101000001001010010100101100010100010001
100000001000000010000001000000100000001
100100001C0010001C000001C00000100000001
111111101111111011111101111110111111101
100000001C0010001C000001C00000100000001
100100001000000010000001010010100100001
100101001001010010100101000000100100001
100100001001010010100101001100100100001
100100001000000010011001000000100101001
1000000C10001000100000010100101000000C1
101111111011111110111111011111101111111
100000001000000C1000000100000C100000001
100001001000000010010001010100100101001
100101001001010010011001000000100101001
100001011000100010010001010100100010001
1C000000100000001C0000010000001C0000001
111111101111111011111101111110111111101
100000001C0010001C000001C000001C0010001
100000001000000010100101000100100000001
100000001001010010000101000100100101001
1000P0001001010010010001000100100101001
100000001000000010010001010000100101001
100000001000100010000001010010100000001
100000001000000000000001000000000010001
111111111111111111111111111111111111111
