111111111111111
100001000000001
1C0001000011101
1110010C1000101
100C0000000E0P1
111111111111111
